1111111111111111111111111111
1E0010C000000000000000000001
1110111000000111111111111111
1P001111100111CC000000000001
1000000000000111111111000001
100C000000000000000000000001
1111111111111111111111111111