11111111
10000001
1P0C0E?1
11111111