11111111111111111111111111
10E01100C101010000000000P1
1001000011001000111100C001
10000011110001001000000001
10000010010000001111111111
10000000011111000000000001
1001C000100000000101000001
10000000000000000000000001
10000100000111110000C00001
1E0C010001000001000000C0E1
1000C001010000010000C00001
10110000110000011110000001
11111111111111111111111111